Hallo=Welt
Sascha=Sascha â¤ï¸ğŸ¥°ğŸ’•
Kontrollverlust 40k e.V.=Kontrollverlust 40k e.V.
Mars=Mars
Raul Foamte=Raul Foamte
CSMWINTER2025=CSMâ„ï¸WINTERâ„ï¸2025
Elmar=Elmar
Mom=Mom ğŸ¥°â¤ï¸
Student Living Center=Student Living Center
Nonna=Nonna
Peter=Peter
Nicki=Nicki ğŸ¥°
Hausmeister SLC=Hausmeister SLC
Kaufen und Verkaufen (alles anbieten und bei Interesse fuer etwas auch schreiben)=Kaufen und Verkaufen (alles anbieten und bei Interesse fÃ¼r etwas auch schreiben)
Thomas=Thomas
Luka Hierl=Luka Hierl
Patrice Uebe=Patrice Uebe
Test=Test
We are family=We are family
EI TUM 5. Semester=EI TUM 5. Semester
Elektro- und Informationstechnik 5.Sem=Elektro- und Informationstechnik 5.Sem
Eltech Leute=Eltech Leute
Medientechnik  intelligente interaktive Systeme=Medientechnik & intelligente interaktive Systeme
WhatsApp=WhatsApp
Geteiltes Leid ist halbes Leid=Geteiltes Leid ist halbes Leid
Maccarony=Maccarony
Mittwoch Home Meeting=Mittwoch Home Meeting
Janus=Janus
Kaeeede=Kaeeede
Julia ECE=Julia ECE
Spam=Spam
DND=DND
